= link:programming.html[Programming] / Fonts =

Windows 下的等寬字型有：

 * BatangChe - 中文字有角，有倚天中文的 Fu。
 * Consolas - 中文字有點破。
 * Courier (New) - 中文字有點破。
 * DejaVu Sans Mono - 英文字不錯看，但中文字有點破。
 * DotumChe - 跟 BatangChe 很像。
 * FangSong - 中文字是宋體。
 * Fixedsys
 * GulimChe - 跟 BatangChe 很像。
 * GungsuhChe - 中文字有角。
 * KaiTi - 中文字像宋體。
 * Liberation Mono - 英文字不錯看，但中文字扁扁的？
 * Lucida Console - 英文字不是很平滑。
 * Lucida Sans Typewriter - 英文字是斜體
 * Miriam Fixed - 英文字粗細不一，但跟中文字有點不搭。
 * MS Gothic - 跟 BatangChe 很像。
 * MS Mincho
 * NSimSun - 跟 BatangChe 很像，但問號很難看。
 * OCR A Extended - 英文字很特別，但跟中文字有點不搭。
 * Rod - 英文字有粗細不一。
 * SimHei - 中英字都爛爛的。
 * Simplified Arabic Fixed - 英文字粗細不一，中文字有點破。
 * SimSun - 問號很難看。
 * SinSun-ExtB - 英文字有點糊糊的。
 * 細明體
 * 細明體_HKSCS
 * 細明體_HKSCS-ExtB - 英文字有點糊糊的。
 * 細明體-ExtB - 英文字有點糊糊的。
 * 標楷體

最後 Rod 勝出...

== 參考資料 ==


 * http://hivelogic.com/articles/top-10-programming-fonts/[Top 10 Programming Fonts] (2009-05-17)
 * http://www.sitepoint.com/top-10-programming-fonts/[10 of the Best Programming Fonts - SitePoint] (2009-05-01)
